15 20
#########1##########
#########1##########
#########1##########
#########1##11111111
#########1##1#######
#########1##1#######
#########1##1#######
#########1##1#######
#########1##1#######
#########1##1#######
#########1##1#######
#########1##1#######
#########1##1#######
#########1111#######
####################