15 20
##1111111$##########
##1#################
##1#################
##1######1111#11111*
##1######1##1#1#####
##1######1##1#1#####
##1######1##1#1#####
##1######1##1#1#####
##1######1##1#1#####
##1######1##1#1#####
##1######1##1#1#####
##1######1##1#1#####
##1######1##1#1#####
##11111111##111#####
####################